dca-miR156a	TGACAGAAGAGAGTGAGCACACATAGTACTTTCTCGCATGATGGATGCCAGAAGCTCTGCGTGCTCACCCTCTATCTGTCATC	5'
dca-miR157a	TTGACAGAAGATAGAGAGCACAGATGATGAAGTGCAGCAAGAGCCTGCATCTCACTCCTTTGTGCTCTCTATGCTTCTGTCATCA	5'
dca-miR159a	GAGCTCTCTGAAGTCCAATAGAGGAACTAACAGGGAAGATAAAGCTGCTGATCTATGGATCCCTCAGCCCTAAAAACTTGACAAAATATTTAGGGTTGTGGCTTGCATATGTCAGGAGCTGCATTACCTTTGTTGAGCTCCTTGTTTGGATTGAAGGGAGCTCTG	3'
dca-miR160a	TGCCTGGCTCCCTGTATGCCACTTGCAGATCTCATCGACAACTCGGTGCCTCCGTGAATGGCGTATGAGGAGCCAAGCATA	5'
dca-miR164a	TGGAGAAGCAGGGCACGTGCAAACCGATCCACTCCGGCCTATTTGCACGTGCTCCCCTTCTCCAAC	5'
dca-miR166a	GGAATGTTGTCCGGCTCGATGCTGCAAACTTAGCTAATACAATGTTGTCAAGTGACCGCTAATTATGTAATTAGTCGGGTTGATAGCTAAGTTTGTGTCATCGGACCAGGCTTCATTCCCC	3'
dca-miR166b	GGGATGTTGGCTGGCTCGATGCATTCACTTGTGATGAGATGCAGCTTAGATTTATCCGACCACAAGAATGAAGAATGTGACGGCATCGGACCAGGCTTCATTCCTC	3'
dca-miR167a	TGAAGCTGCCAGCATGATCTTAGTTTTCCTACTTTGGAGAAATCAGATCGTGGTGGTAGCTTCACC	5'
dca-miR167b	TGAAGCTGCCAGCATGATCTATCCAGCTAGCTTTGGATCCTTAAGAAATTCGATTTTTAAGCTTTTGCAAGAAGTTTTTAACACAACAAAGATAGCTAGTTAGGTCATGCTCGGACAGCTTCACT	5'
dca-miR168a	TCGCTTGGTGCAGGTCGGGACCATGTTACACACACCTATACATACATATATTCGTGTATACATATGTTTGTGTGGTCCCGTTTTGCATCAATTGAAT	5'
dca-miR169a	CAGCCAAGGATGACTTGCCGGCCATGTTGGTGGTAAGTGCCAAGCGGTTGGCAAGTCATTCCTGGCTACA	5'
dca-miR169b	TAGCCAAGGATGACTTGCCTAAATCCCCCATCCAATATTATCAGGGCTCAATTTTAATTGTGTTGCCACAATAAGCCCTGTTTAATGTGGTTTTTAGGCGTCGTCCCTTTGGCTAATC	5'
dca-miR169c	TAGCCAAGGATGACTTGCCTGCTCTCATGCAAAGGGGTTTAGTATGTTCTTTCAGCTTTCATATAATGAAGGCTCAAGAAATGGAGACCCCCGCGCTTGAGTTTTCAGGCCGGTCACCTTGGCTAAT	5'
dca-miR169d	TAGCCAAGGATGATTTGCCCAGCTCCCATTTATAAACTGATAAGGGTGACAACACGTAAATGTGTAGTGTTGTTAGCTAGTTACCAGTTTTATTTGTTTCTGCAGGGCGAATCATCCGGGGCTATC	5'
dca-miR169e	TAGCCAAGGATGACTTGCCCCCCACATCCTGTATATAGGGTTTTGCTAGGGCCTGGTATATATTAATGGTTTCAGGCGAGTCATCCCGGCTATC	5'
dca-miR170a	TGTTGGTGCGGTTCAATTTGATAGTGGTGCTTTGCAAGGTTTGAAGCACCGTTCATCTGATTGAGCCGTGCCAATATC	3'
dca-miR171a	TATTGGCCGGGCTCACTCAGATGCGCACATATGCACTTGAATAGTTATGAACGGTGAGTCTGATTGAGCCGCGCCAATATC	3'
dca-miR171b	AGATGTTGGTGAGGTTCAATCCGAAGACGGATTTACAAATTGTTTCCTGTAAAGGACGATCTCAGATTGAGCCGCGCCAATATCACT	3'
dca-miR172a	GTAGCATCATCAAGATTCACATGCAAGATGCAAGATGCAAGATGCAATTAAGTAGTGAGAATCTTGATGATGCTGCAT	3'
dca-miR319a	GAGCTTTCTTCGGTCCACTTATGGGTGGCATGTAGGGTTCAATTAGCTGCTGACTCATTCATCCACATCCTCTAATTAAACACACTTTTAATTACGAGTAATTGAGTGAATGATGCGGGAGACTTATTGAATCTTAAGCTTTCTGTGCTTGGACTGAAGGGAGCTCCC	3'
dca-miR319b	AGCCCCCTGTCAGACCAATACCGAGGGCTTAGTTACGGTTTGAGCTGTCATCTCATGCATTTGGTTATGCTTAGTCTTTCTTGTTTTGCTTATGGAAACTGAAATCCGAGTCCGGGAAACTAAGTCTAGCCTGATGCATGATGTGAGAGCAACTCCTGCCGTGCACCTGAGTCCGCTTATTGGACTGAAGGGAGCTCC	3'
dca-miR390a	AAGCTCAGGAGGGATAGCGCCAACAAAATAACATATGCATGGTGATCTCTATTCCTGAATGTGTGTATTTGTTCAAACTGTCGCGCTATCCATCCTGAGTTTCA	5'
dca-miR395a	GGTTCCTCAAACACTTCATTGGGAATGTTAACTTTGCCTACTGAAGTGTTTGGGGGAACTC	3'
dca-miR396a	TTCCACGGCTTTCTTGAACTGCATCATCATCTCATCTATTTCTCAGATTTAGATGCTGCAGTTCAATAAAGCTGTGGGAAG	5'
dca-miR396b	TTCCACAGCTTTCTTGAACTTCCTAATTGGCTAATTCTCTCTCTCTCTCCCCCTCCCTCTCTCTCTCCCTCCCCCCTCTCTTCCTCTCCCCTCTCCCCCCTCTCTCCCTCCCTCCCTCTCGCCCTCCCTCTGCATGATGTGGAAGTTCAAGAAAACTGTGGGAAG	5'
dca-miR398a	GGAGTGCTGCCTGAGAACACGCGTGCATTTGGAAGCTTGATGCTCTTAGAATACACTTGTGTTCTCAGGTCACCCCTT	3'
dca-miR398b	GGAGCGTCATGAGAACACATCAATTCACATTTAAATTTAAGTTATCCTGTGTGTGATGTGTTCTCAGGTCGCCCCTG	3'
dca-miR399a	GGGCAGCTCTCCTGTTGGCAGCTGATCAAGAGGTGATATTCATCGGTTTCGGTGAAAATCGGATCATCTGCCAAAGGAGAGTTGCCCTC	3'
dca-miR403a	GTTTGTGCGTGAATCTAACAATTCAATCTGTATTCGATTCTCAACATCTGCTTTGAATCGGAGGCTGTTAGATTCGCGCACAAACTC	3'
